1111111111111111111
10000000C0000000001
1001011111000000001
10010000C0000P00001
1001000000000E000
1111011111111111101
10001111101100000C1
1111111111111111111